##################################################
B............####################.........########
#####.#####.#######......#####....#######....#####
#####.......#.......#####.#######.........########
########.################.###########.############
########.################.............############
##.....#........#########.###########.############
######...######.#########........####.........####
########.######.#########.######.############.####
#####....######......####.######.####......##.####
#####.##.###########......######......#######...S#
##################################################